5
5
3 2 2 1 4
1 0 1 1 1
1 1 1 1 3
1 2 2 1 1
1 1 3 1 4
